R 1280 1024

NO texture/grey_camo.xpm

SO texture/grey_dark.xpm

WE texture/grey_metal.xpm

EA texture/grey_light.xpm

S texture/alien.xpm

C 128,128,128

F 247,220,111

        1111111111111111111111111
        1000000000110000000000001
        1011000001110E00002000001
        1001000000000000100000001
111111111011000001110000000000001
100000000011000001110111111111111
11110111111111011100000010001
11110111111111011101010010001
11000000110101011100000010001
10000000000000001100000210001
10000000000000201101010010001
1100000111010101111101111000111
11110111 1110101 101111010001
11111111 1111111 111111111111
